111111111111111111
111EC000000CC00111
11100011C000000001
111C1CCCCCCC111111
11C000000CCC011111
11C00CCCC000011111
11C000000000011111
111C00CCC000001111
111C00000CCCC01111
111C0000CCCCC01111
111C0CC000CC001111
111C000CCCC0001111
111P0CCC1111111111
111C00000CCCC11111
111111111111111111