11111111111111111111111
1010P00CC0C000000CCCCC1
10C00E000111CCCC0001111
11111111111111111111111