111111111111111111111111111
1CCCCCCCCCCCC1CCCCCCCCCCCC1
100000000000000000000000001
100000000000000000000000001
100000000000000000000000001
100000000000000000000000001
100000000000000000000000001
100000000000000000000000001
100000000000000000000000001
100000000000000000000000001
100000000000000000000000001
10000000000000000CCCCCCCCC1
100000000000000000000000001
111111C1C1001E1001C1C111111
100000000000010000000P00001
111111111111111111111111111